11111111111111111111111111111
1P000000000000000000000000001
10010001001001100111001110001
10011011011101010010011011001
10010101010101100010010001001
10010001011101010010011011001
10010001010101010111001110001
10C001000CC00C000010000101001
10C001110000000011100001E1001
10000001111C01111000001101001
10000000000000000000001001001
1000E000000110000000001010001
10000000000000000000000000001
11111111111111111111111111111
